Telttur - 
Bæk - 
Kattemad - En lækker mus
Huskatte - Kæledyr
Passion - Engagement
Romantik - Middagslys og roser
Minder - Fortidens glæder
Gesims - Udkragning ved taget
Kvist - Udbygning på taget
Mosaik - Mønster
Tulipaner - Gave fra haven
Drømme - Ønsketænkning
Omhu - Øje for detaljen
Strategisk - Planlæggende
Hus - Familiens base
Høvding - Husets overhoved
Ida - Pigenavn
Morten - Drengenavn
Gråsten - By i Sønderjylland
IPA - Øl
Makrel - Delikatesse på dåse
Tomat - Hendes grøntsag
Agurk - Hans grøntsag
Chokolade - Bittert og sødt
Champagne - Bobler
Vin - Gamle druer
Gin og tonic - En drink
Steg - En flot kvinde
Zoo - Abebur
Guldsmykke - En gave til hende
Persisk tæppe - En gave til ham
Fransk søm - En sømteknik
Kontrolingeniør - Han har officielt denne titel
Software - Programmer og applikationer
Symaskine - Apparat
Ubuntu - Styresystem
Kerning - Pæn bogstavafstand
